
‚úÖ FEITO
Fun√ß√£o	Assert sugerido
deletarUsuario()	assertTrue($resultado)
cadastrarUsuario()	assertIsInt($idUsuario) ou assertGreaterThan(0, $idUsuario)
editarUsuario()	assertTrue($resultado)
loginUsuario()	assertNotEmpty($usuario) ou assertEquals($email, $usuario['email'])
cadastrarEndereco()	assertIsInt($idEndereco)
editarEndereco()	assertTrue($resultado)
deletarEndereco()	assertTrue($resultado)
deletarFuncionario()	assertTrue($resultado)
listarFuncionario()	assertIsArray($funcionario)
listarEndereco()	assertIsArray($endereco)
cadastrarAssinatura()	assertIsInt($idAssinatura)
renovarAssinatura()	assertTrue($resultado)
deletarAssinatura()	assertTrue($resultado)
cadastrarPlano()	assertIsInt($idPlano)
editarPlano()	assertTrue($resultado)
listarPlanos()	assertIsArray($planos)
deletarAvaliacaoFisica()	assertTrue($resultado)
editarDieta()	assertTrue($resultado)
deletarDieta()	assertTrue($resultado)
listarDietas()	assertIsArray($dietas)
editarCargo()	assertTrue($resultado)
deletarCargo()	assertTrue($resultado)
editarMetaUsuario()	assertTrue($resultado)
deletarMetaUsuario()	assertTrue($resultado)
cadastrarTreino()	assertIsInt($idTreino)
editarTreino()	assertTrue($resultado)
listarTreinoExercicio()	assertIsArray($exercicios)
deletarTreinoExercicio()	assertTrue($resultado)
editarExercicio()	assertTrue($resultado)
deletarRefeicao()	assertTrue($resultado)
üöß EM ANDAMENTO
Fun√ß√£o	Assert sugerido
deletarCupomDesconto()	assertTrue($resultado)
deletarProduto()	assertTrue($resultado)
deletarPagamento()	assertTrue($resultado)
‚ùå PENDENTE
Fun√ß√£o	Assert sugerido
gerenciarVencimento()	assertTrue($vencimentoAtualizado) ou assertIsArray($assinaturasAtualizadas)
listarCupomDesconto()	assertIsArray($cupons)
editarCategoriaProduto()	assertTrue($resultado)
listarPedidos()	assertIsArray($pedidos)
listarProdutos()	assertIsArray($produtos)
editarAulaAgendada()	assertTrue($resultado)
recuperacaoSenha()	assertStringContainsString('Email enviado', $mensagem)
cadastrarRefeicao()	assertIsInt($idRefeicao)
cadastrarCupomDesconto()	assertIsInt($idCupom)
cadastrarPedido()	assertIsInt($idPedido)
statusPedido()	assertEquals('enviado', $status) (exemplo de status)
cadastrarRespostaForum()	assertIsInt($idResposta)
editarHorario()	assertTrue($resultado)
listarForum()	assertIsArray($topicos)
cadastrarForum()	assertIsInt($idTopico)
listarHistoricoTreino()	assertIsArray($historico)
aplicarDesconto()	assertEquals($precoComDesconto, $produto['preco'])
editarHistoricoTreino()	assertTrue($resultado)
editarForum()	assertTrue($resultado)
editarCupomDesconto()	assertTrue($resultado)
listarPagamentos()	assertIsArray($pagamentos)
editarPagamento()	assertTrue($resultado)
editarDietaAlimento()	assertTrue($resultado)

teste unitario e composer